NO src/img/wall_stoun.png
SO src/img/wall_stoun.png
WE src/img/wall_stoun.png
EA src/img/wall_stoun.png

F 220,100,0
C 225,30,0

1111111111111111111111111111111
1010000000000010000010001000001
1011111011111011101010101011101
1010001000001010001000101000101
1010101111101010111111111110101
1000100000001010000010000000101
1111111111111011101010111111101
1000000010001000101000100000101
1010111110101110111111101110101
1010000000100010000000101000101
1011111111111011111110101011101
1000100010000000100010001000001
1110101010111011101011111111101
1000001010001010001000000010001
1111101111101110111111101010111
1000101000100010001000101010101
1010111010111011101010101010101
1010000010100010001010101010001
1011111110101110111010101111101
1000101000101000100010100000101
1010101011101011101111111110101
1010100010001010000000000010001
1010111010101010111111101111111
1010001000101010100000100000001
1011101110111010101110111110101
1000100010100010100010000000101
1110111011101110111011111111101
1000001000101000001010000010001
1111111110101110111010111011111
1000001000100010100010100010001
1011101010111010101110101110101
1010000010001010100000100000101
1010111111101011111111111111101
1010001000101000001000001000001
1011111010111111101011101011101
1000000010000010101010101000101
1011111111101010101010101010101
1010000010001000100010001010101
1011111010111110111110111110101
1010000010100010001010000000101
1010111010111011101011111111101
1010001010001000101000001000101
1011101011101010101011101110101
1000001000101010001000100010101
1011111111101111101010111010101
1010000000101000101010100010101
1110111110101010101110101110101
1000101000100010101000100000101
1011101011111110101011111110101
1000100000100000100010000000101
1010111110101111101111111111101
1010000010001010001000000000001
1011111011111010111011111111111
1010001000100010101000001000001
1110101110111010101111101110101
1000100010001000001000100000101
1011111011101011111010111111101
1010000000101010100010001000001
1011111110101010101110101011111
1000000010001000100010101000001
1011111011111011111010111111101
1000001000001010001010000000101
1111101111101010101011111011101
1000101000101010100010001000101
1110101110101010111110101110101
1000100010101010001000100010001
1010111010101111101111111011111
1010100000100000100010000010001
1011101111111110111010111010101
100000001000001000100N100010101
1011111110111010101111101110101
1010100000100010100000100010101
1010101011111010111110111010101
1000101010001010100010101000101
1110101110101010111010101111101
1010100010101000100010000010001
1010111010101111101110111110111
1000100010100010000000100010001
1011101010111011111111101011101
1010101010101000000000001000001
1010101110101111111111111111111
1010101000100000100010000000001
1010101011111010101010111111101
1010100010000010001010100000101
1010111110111111111011101110101
1010000000100000001000101000101
1010111111101111111110101011101
1000100010001000100010101000101
1111101110101010101010101110101
1000000000100010001000001000001
1111111111111111111111111111111
