NO src/img/wall_broun.png
SO src/img/wall_broun.png
WE src/img/wall_broun.png
EA src/img/wall_broun.png

F 220,100,0
C 225,30,0

1111111111111111111111111111111
1000000010000000100000100000001
1111111010111110101011101011101
1000001010000010001000001000101
1010111011111011111111111110111
1010001000101010000000000010001
1011101110101011101110111111101
1010000010101000001010100010001
1110101110101111111010101010101
1000101000100000000010101010101
1011111011111011101110101010101
1000100010001000100000101000101
1110101110101111111111101111101
1000101000100000100000001000001
1010101011111110101111101111101
1010100010100010101000001000101
1011111110101010101011111010101
1000000010001010101000100010101
1011101010111010101110101110101
1010001010100010100010101010101
1010111010101010111011101010111
1010101010101010001000000010001
1010101010101111101111111110101
1010101010100010001000100010101
1010101010111010111010101011101
1010101010001000100010101000101
1110101011101111101110101110101
1000100000100000100010001000101
1011111111111110111011111011101
1000000000000010001010001010001
1011111111111011101010111011101
1000101000001000101010001000101
1110101011101110101010101110101
1000001010100000100010100000101
1011111010111110111110111111101
1010000010100010101000100000001
1010111110101010101011101011111
1010100000001000101000101000001
1110101111111111101110111111101
1000100000000000000010100000001
1011111011111111111110101111101
1000001010000000000010001000101
1011101110111111111011111011101
10101000001000001000000N0010001
1010111111111010101111111010111
1000001000001010100010000010101
1111101011101010111011111110101
1000101000100010001000000010101
1011101110111111101111111010101
1000000000100000000000001000001
1111111111111111111111111111111
