NO src/img/wall_stoun.png
SO src/img/wall_stoun.png
WE src/img/wall_stoun.png
EA src/img/wall_stoun.png

F 220,100,0
C 225,30,0

111111111111111111111111111111111111111111111111111
101000001000000000000000000000000000100000100010001
101011101111101111111111101011111110101110101010101
100010001000100000100000101010100010001000101000101
111110111010111111101110101010101011111011101111101
100010000010000000001010101010001000000010000010101
101011111111111111111010101010111111111111111010101
101000000000100000100000101010000000100000001000101
101111111111101110101111111011111110101111101110101
101000001000000010101000000010000010001000101000101
101011101011111110101011101111111011111011101011101
101010100000100010101010001000100010001000101000101
101010111111101010101110111010101011101010101011101
101010001000001000100010100010001000100010101010001
101011101011111110111010111011111110111110101110101
101010001000100000101000100010001000000000101000101
101010101110111011101111101110101111111111101011101
1010001000100010001N0010000000100000000000101010001
101011111011101110101010111111111111111110101011111
100010001010001010101010100000100000100010001010001
101110101110111010101010101110111010101111111010101
100010100000101000101010001010000010100000001000101
111010111111101011111011111011111110111110111011101
100010001000101010000010000000100000100010000000101
101111101010101010111010101111101111101011111111101
100010001010100000100010101000001000001000000010001
111110111010111111111110101011111011111111111010111
100000100010100000001000101000000010000000100010001
101111101110101111101011101111111110111011101111101
100000000010000000100000100000000000001000000000001
111111111111111111111111111111111111111111111111111
