NO src/img/north.png
SO src/img/south.png
WE src/img/west.png
EA src/img/east.png

F 220,100,0
C 225,30,0

111111
100101
01101
110001
111111